WWWWWWWW
WLWWLLLW
WWWWLLWW
WWWLLLWW
WWLLLLWW
WWWWWWWW
