WWWWWWWWWWWWWWWW
WLWWLLLWWWWWWWWW
WWWWLLLWWWWWWWWW
WWWLLLWWWWWWWWWW
WWLLLLWWWWLLLWWW
WWWWWWWWWWLLLWWW
WWWWWWWWWWLLLLLW
WWWWWWWWLLLLLLLW
WWWLLLWWWWLLLLWW
WWLLLWWWWWWWWWWW
WLLLLLWWWWWWWWWW
WWWWWWWWWWWWWWWW
