WWWWWWWWWWWWWWWWWWWWWWWWWWWWWWWW
WWWLLLLLLLLLWWWWLLLWWWWWWWWWWWWW
WWLLLLWWWWLLWWWLLLLLWWWWWWWWWWWW
WWWLLLLWWLLWWWWWLLLLWWWWWWWWWWWW
WWWWWLLLLLWWWWWWWWWWWWWWWWWWWWWW
WWWWWWWWWWWWWWWWWWWWLLLLLLLWWWWW
WWWWWWWWWWWWWWWWWWWWWWLLLLWWWWWW
WWWWWWWWWWWWWWWWWWWWLLLLLWWWWWWW
WWWWWLLLLLLWWWWWWWWWWWWWWWWWWWWW
WWWWWLLLLWWWWWWWWWWWWWWWWWWWWWWW
WWWWWWWWWWWWWWWWWLLLWWWWWWLLLWWW
WWWWWWWWWWWWWWWWLLLLLWWWWWLLLLLW
WWWWLLWWWWWWWWWLLLLLWWWWWLLLLWWW
WWWLLLWWWWWWWWWWWWWWWWWWWWWWWWWW
WWWWWWWWWWWWWWWWLWWWWWWWWWWWWWWW
WWWWLLLLWWWWWLWWWLWWWWWWWWWWWWWW
WWWWLLLLWWWWWWWWWWWWWLWWWWWWWWWW
WWWWWWWWWWWWWWWWWWWWWWWWWWWWWWWW
WWWWWWWWWWWWWWWWWWWWWWWWWWWWWWWW
WWWWLLLLLLLLLWWWWWWWWLLLLLLWWWWW
WWWLLLLLLLLLWWWWWWWWWWWLLLWWWWWW
WWWLLLLLLLLLLWWWWWWWWWWWWWWWWWWW
WWLLLLLLLLLLLLWWWWWWWWWLLLLLWWWW
WWWWWWWWWWWWWWWWWWWWWWWWWWWWWWWW
